%%%%%%%%%%%%%%%%%%%%
%%% %  % %  %    % %
%    %%   .%%   %  %
%   %   %. %  % %  %
%%   %%%%%     %%%%%
%     %     %  %% %%
%%   %%%%    %    %%
%   %      %%   % %%
% % %% %  % .   % %%
%  %      .  %%%   %
%%%         %  %. %%
% .      %%  %   % %
%%%   %%  %  %.  % %
%% .    %%% .    % %
%    %   . % %% %  %
% % %    %    %%   %
% %%  %%%          %
%  P  %%  %       %%
%     %    %      %%
%%%%%%%%%%%%%%%%%%%%
